BQ 0 13 22BBBBBBBBBBBBBBBBBBBBBBBBBBBBQ 2 6 22B
B_______________XXXXXXXXXXX____B
B_________________XXXXXXXX%____B
B___________________XXXX%%_____B
B_____________________%%%______B
B______________________________B
B______________________________B
B__%%__%%___________________XXXB
B_________________________XXXXXB
B___________________________XXXB
B___________________________XXXB
B_________________________XXXXXB
B_____________________________XB
B_________________%%%__________B
B______________________________B
B______________________________B
B__%%%%________________________B
B______________________________B
B______________________________B
B______________________________B
B______________________________B
B____________________________%%B
B%%_______%%%%_____%%_______%%%B
BBBBBBBBBBBBBBBBBBBBBBBBBBBBBBBB